11111111111111111111
10100000C00000000001
10100000000000001111
10P0000000C0000000E1
10000001000000001111
100C0001000000000001
11111111111111111111