11111111111111111111
11P100000000C00000E1
10100000000000000001
10000000000000000001
10000000000000000001
11111111111111111111